"","qb","rb","wr","te","ol","offense","idl","edge","lb","s","cb","defense","control","total","year","id"
"1",13385137,10203112,19241989,5509036,25664899,74004173,5264666,10241101,10004817,6920158,6032738,38463480,99082516,112467653,2013,1
"2",1557085,10799653,16831423,12778788,27955261,69922210,7701509,25013832,7377232,8579619,3507877,52180069,120545194,122102279,2013,2
"3",6336958,15376098,12686896,6979500,26721984,68101436,6496528,8776293,5740835,10777066,9602477,41393199,103157677,109494635,2013,3
"4",18716295,5070632,10120554,8013902,24318758,66240141,6880138,5313554,12951882,5894346,17559225,48599145,96122991,114839286,2013,4
"5",21998400,5036739,8677626,2998913,24235900,62947578,5118995,9523813,7916847,12704990,11202110,46466755,87415933,109414333,2013,5
"6",11756250,10825134,14247672,6948519,18690874,62468449,15386734,3770636,7593313,7816547,16655776,51223006,101935205,113691455,2013,6
"7",18193235,9159749,11679433,3245951,18150025,60428393,6485380,14326594,11034166,9960582,11598369,53405091,95640249,113833484,2013,7
"8",8470554,15752460,10378281,4582245,20329032,59512572,11556066,24552100,13577945,5691438,4206849,59584398,110626416,119096970,2013,8
"9",15996516,5201250,10926398,8795715,17428226,58348105,6241425,13838120,4555052,11490435,4839588,40964620,83316209,99312725,2013,9
"10",10920140,6293062,17406642,6938146,16464048,58022038,9806798,8139270,8433728,7249890,9276181,42905867,90007765,100927905,2013,10
"11",21556666,3987009,15383546,4207277,12601451,57735949,14671559,7814297,10468126,4758334,6133807,43846123,80025406,101582072,2013,11
"12",2897535,9182062,16963177,10569598,17581156,57193528,11028483,10194288,7666512,10696955,13185741,52771979,107067972,109965507,2013,12
"13",14759018,4154535,12811933,2593765,20679882,54999133,5447833,4476989,15203295,3028114,13025418,41181649,81421764,96180782,2013,13
"14",13013000,2429420,10223980,11341695,17211503,54219598,15831195,12650974,9100786,4969273,13957143,56509371,97715969,110728969,2013,14
"15",14603953,3682367,8749814,4150882,22775490,53962506,15169500,6420702,10801171,7386653,8618787,48396813,87755366,102359319,2013,15
"16",5972967,2212882,19735321,4645357,20025614,52592141,14227749,9152416,10476684,4619719,7102431,45578999,92198173,98171140,2013,16
"17",11276471,12036166,16580067,2495000,10071052,52458756,10999363,18744765,12510915,3802254,15375000,61432297,102614582,113891053,2013,17
"18",7579454,9290450,11041036,4325000,18981126,51217066,5096152,11629844,12335911,6639853,3244456,38946216,82583828,90163282,2013,18
"19",6172993,5306754,15022466,4425078,19171690,50098981,20498000,5347625,7964030,2809618,10407900,47027173,90953161,97126154,2013,19
"20",13818982,2257011,8120768,5623758,19470710,49291229,4133225,20864805,7285429,3626564,12623808,48533831,84006078,97825060,2013,20
"21",8626545,7195732,11908481,2615661,18601449,48947868,13140390,16498650,4492779,13323235,9596407,57051461,97372784,105999329,2013,21
"22",10708333,5379755,8668150,3435650,20708982,48900870,13759289,17451636,5081500,13251425,13096878,62640728,100833265,111541598,2013,22
"23",13705176,2637944,5479738,6217555,19240160,47280573,9376091,13967275,15711252,3645196,17453159,60152973,93728370,107433546,2013,23
"24",1184375,4644753,13444505,2393504,25305673,46972810,14773893,5032152,5804388,13033579,19521921,58165933,103954368,105138743,2013,24
"25",15393138,2549641,8799844,9207474,10836255,46786352,12586770,12823812,9155304,16480395,11069889,62116170,93509384,108902522,2013,25
"26",8347588,9012941,6832868,7160882,14812080,46166359,4612010,9323215,13544999,2631626,3572072,33683922,71502693,79850281,2013,26
"27",2862833,5750703,8730272,5005166,22390147,44739121,13979869,24778885,8370673,5834061,16118302,69081790,110958078,113820911,2013,27
"28",7381327,7936927,7986810,3966000,16354916,43625980,17275372,19320572,4593000,3813423,10949281,55951648,92196301,99577628,2013,28
"29",4663940,8362867,8979223,4489668,14455361,40951059,16611040,13270000,5414838,10503423,7069748,52869049,89156168,93820108,2013,29
"30",5859205,2412352,8242874,6007127,17575011,40096569,15944118,11848139,9006508,5027138,13351955,55177858,89415222,95274427,2013,30
"31",4171299,2200883,5666354,2620527,23789034,38448097,19697955,14276906,7765000,2500318,10928931,55169110,89445908,93617207,2013,31
"32",1146517,11735884,4609651,1496363,10275023,29263438,5163512,2078750,6548030,6752294,6782330,27324916,55441837,56588354,2013,32
"33",18576474,6980028,17966288,1247246,26480666,71250702,14382019,9969271,7666852,7645545,5342576,45006263,97680491,116256965,2014,1
"34",19064118,5399617,12178739,6269241,25334966,68246681,8932135,5228215,10041920,9017368,8305918,41525556,90708119,109772237,2014,2
"35",18629094,2748063,18771159,3669295,22809266,66626877,7401361,11939602,10595503,7141122,15320403,52397991,100395774,119024868,2014,3
"36",17856766,8605886,10851816,9315091,19973727,66603286,7275737,12045271,6024227,13044216,6186511,44575962,93322482,111179248,2014,4
"37",19930000,3635133,7489962,8642056,26264010,65961161,12047009,21708707,13272617,4207611,3599498,54835442,100866603,120796603,2014,5
"38",3772237,16415834,10693053,5720045,29339566,65940735,6088275,17791018,10285319,7603608,13632290,55400510,117569008,121341245,2014,6
"39",19219118,9580845,12299126,7234947,16590321,64924357,4235688,14352349,10686451,4434278,11742197,45450963,91156202,110375320,2014,7
"40",9024346,5275190,28597229,2453213,19150146,64500124,8558325,16269884,19901899,7286117,12603136,64619361,120095139,129119485,2014,8
"41",10278077,13954903,10289462,3870027,24118962,62511431,9823887,16318199,13041933,3934664,7924243,51042926,103276280,113554357,2014,9
"42",4907663,9457433,19869037,4412445,22861050,61507628,8117519,8070107,8574142,3124451,17795552,45681771,102281736,107189399,2014,10
"43",6114325,8372771,14014025,9364040,22908605,60773766,14858320,9959422,14238165,7042189,7623157,53721253,108380694,114495019,2014,11
"44",21008400,5120134,12922572,2083825,19002962,60137893,6171260,6942313,14546482,14367378,11998314,54025747,93155240,114163640,2014,12
"45",17031668,6083043,18606777,5509002,11871158,59101648,27994602,10114648,13479446,5342000,4023173,60953869,103023849,120055517,2014,13
"46",7082926,2678257,18448822,3831981,26783400,58825386,22282539,15092287,5082772,3143824,7461353,53062775,104805235,111888161,2014,14
"47",5402878,6138225,15118083,3321133,27006154,56986473,7501734,7897645,9264790,4571367,7604495,36840031,88423626,93826504,2014,15
"48",6035575,6896110,9394069,8033603,26321377,56680734,14188978,9059903,6628324,14007775,10683260,54568240,105213399,111248974,2014,16
"49",15446036,4537291,13923556,7369559,15395126,56671568,10516902,5631786,12844605,8593385,15181481,52768159,93993691,109439727,2014,17
"50",8786939,11495196,17692219,6165390,12179435,56319179,14297941,16416918,7815650,14822053,8579227,61931789,109464029,118250968,2014,18
"51",21333138,1669039,7942649,7847766,14731514,53524106,9360367,13428435,15222160,10751868,13352245,62115075,94306043,115639181,2014,19
"52",10928123,3654864,10856116,8253862,19718975,53411940,16160671,14597786,13702366,6534061,17739200,68734084,111217901,122146024,2014,20
"53",19273750,2878903,9395943,2464445,18882444,52895485,7465236,23761153,11140825,7570989,19240070,69178273,102800008,122073758,2014,21
"54",12764666,2815945,5655361,9965144,21402763,52603879,5927135,5288895,10078315,4115045,21287488,46696878,86536091,99300757,2014,22
"55",16676701,2653397,14667325,4410632,13774076,52182131,25825251,9394096,6943566,3473804,16867423,62504140,98009570,114686271,2014,23
"56",5512169,3929661,17087432,4133809,20487478,51150549,26581339,14179861,4809468,10665150,12689893,68925711,114564091,120076260,2014,24
"57",8743113,11891700,4162200,9273200,16431582,50501795,6505547,26696480,9299071,4944876,1839412,49285386,91044068,99787181,2014,25
"58",2807980,1529301,10771737,4683350,30648671,50441039,17269848,13935899,7257125,6699334,17398562,62560768,110193827,113001807,2014,26
"59",9554830,6308882,8703307,10592682,15272558,50432259,11745833,17144223,13828131,2960477,4986002,50664666,91542095,101096925,2014,27
"60",2227438,9949013,6213265,7351109,23339609,49080434,11876832,14437175,11003673,14824595,6488073,58630348,105483344,107710782,2014,28
"61",15578427,1891185,6901832,4991340,17657641,47020425,21184683,14137592,5493818,5389608,11857910,58063611,89505609,105084036,2014,29
"62",6126486,11520979,6857046,3098194,19208595,46811300,13808832,23537100,12589051,7300537,12531233,69766753,110451567,116578053,2014,30
"63",9779454,4019936,11976863,2894739,16559625,45230617,18595139,16302457,7916347,7474934,15753451,66042328,101493491,111272945,2014,31
"64",9471691,6996329,9015614,1400205,17354097,44237936,8198430,14641333,5264934,13433828,11631671,53170196,87936441,97408132,2014,32
"65",19067139,2115642,23083075,7984142,25231140,77481138,9780662,21029315,3297368,11305871,13543730,58956946,117370945,136438084,2015,1
"66",5245038,16960950,15700531,8705993,29660487,76272999,10108617,15465984,11870684,5565439,14643487,57654211,128682172,133927210,2015,2
"67",8997885,3242342,24335809,5451490,27764389,69791915,20732031,9316339,7356014,6696517,10756352,54857253,115651283,124649168,2015,3
"68",5192407,6431875,20552089,4191281,33201673,69569325,17349030,3696387,10546255,8846076,31508947,71946695,136323613,141516020,2015,4
"69",17392354,12012071,9224526,6878554,23951203,69458708,8704164,16527523,8452587,11129568,13900914,58714756,110781110,128173464,2015,5
"70",14791795,4340249,16040318,12066813,21165260,68404435,7937534,12837644,12503493,11471634,4536710,49287015,102899655,117691450,2015,6
"71",23002368,7201545,8556430,10790590,18814927,68365860,13709705,4619834,10188872,12240418,9571186,50330015,95693507,118695875,2015,7
"72",18498450,5554369,25484600,7702332,10416454,67656205,12313980,11899684,13578562,8736044,5062376,51590646,100748401,119246851,2015,8
"73",16725388,11448751,12781274,7560294,17921204,66436911,5097132,17841113,4210126,8796854,6925380,42870605,92582128,109307516,2015,9
"74",11834168,2946734,16186291,5182957,29469242,65619392,23944442,5601270,9462857,4181310,22409565,65599444,119384668,131218836,2015,10
"75",20208674,2086750,23948138,2839587,15191609,64274758,14046673,11391348,6048588,7655153,5104050,44245812,88311896,108520570,2015,11
"76",15429000,9847396,8456702,8146666,21230527,63110291,6489428,23632158,18067227,5187392,4940895,58317100,105998391,121427391,2015,12
"77",10238778,4040770,18726078,3962305,26041777,63009708,14160300,11753976,20598622,8119150,16808890,71440938,124211868,134450646,2015,13
"78",8194273,5564721,7847093,16447200,24810232,62863519,22356097,12025078,13628224,5375948,9416089,62801436,117470682,125664955,2015,14
"79",25358586,5692821,9440930,3887942,18404737,62785016,4811895,5489433,10157172,11168099,9757823,41384422,78810852,104169438,2015,15
"80",15240800,6883801,14975789,1889705,23070742,62060837,5124721,13672478,10989660,3336069,17527051,50649979,97470016,112710816,2015,16
"81",20090908,2917044,13021509,3295825,21065314,60390600,10632552,35680871,1045193,10790891,13207797,71357304,111656996,131747904,2015,17
"82",16944412,2913788,9824791,8910235,20756704,59349930,6445633,14548637,7764297,17048671,7299764,53107002,95512520,112456932,2015,18
"83",20358139,3265082,10701027,6131594,18800947,59256789,14557602,7727575,13207206,5560650,13377624,54430657,93329307,113687446,2015,19
"84",16983000,3636824,11395882,8455213,17609241,58080160,3212519,16676513,12864734,5252185,24161659,62167610,103264770,120247770,2015,20
"85",17234471,4458248,13805614,2762661,19757909,58018903,6591793,11474979,10783706,8880119,6467970,44198567,84982999,102217470,2015,21
"86",8093954,1964338,14792090,5193030,27241456,57284868,15138196,14097291,9223625,11656943,23514408,73630463,122821377,130915331,2015,22
"87",21476940,9656539,6172669,2273413,16685651,56265212,11816841,13645289,8095994,14112700,11077574,58748398,93536670,115013610,2015,23
"88",5218449,4573838,11865185,15475441,18702572,55835485,10316492,37018755,10685780,8220899,4293600,70535526,121152562,126371011,2015,24
"89",1918064,3907750,12243561,4799545,31155998,54024918,10429225,13003817,12767283,14730695,4515992,55447012,107553866,109471930,2015,25
"90",5965886,5081515,18129732,4336557,20141348,53655038,23969929,5445509,12188387,4087338,8260432,53951595,101640747,107606633,2015,26
"91",8554868,10635847,9888081,10063162,12810650,51952608,9600635,18100443,12650324,13893024,15557555,69801981,113199721,121754589,2015,27
"92",6357837,10875801,6411093,5702571,22553824,51901126,20580901,9018355,12609806,4828838,23059240,70097140,115640429,121998266,2015,28
"93",10966900,5547765,13153178,4034629,14365795,48068267,14935562,24983566,10511983,5801282,21055447,77287840,114389207,125356107,2015,29
"94",7625864,2623010,7039908,6819535,23159445,47267762,11620268,18738508,9272473,10861046,14670090,65162385,104804283,112430147,2015,30
"95",3732738,7707163,12781663,5735146,15086305,45043015,16827353,27384012,7282129,5657363,16809630,73960487,115270764,119003502,2015,31
"96",5017020,5286810,8113034,10447500,11157861,40022225,21122812,10312803,6083453,12937775,15939246,66396089,101401294,106418314,2015,32
"97",23926148,9073966,19837501,9867494,21408752,84113861,4585559,10409388,15942586,8367517,20670361,59975411,120163124,144089272,2016,1
"98",22237334,2428948,23519793,8387911,26070817,82644803,9823954,11615247,4179207,7736030,10733385,44087823,104495292,126732626,2016,2
"99",25334805,4433346,16885326,4133728,28392364,79179569,14224578,10044940,20449321,7261255,6603699,58583793,112428557,137763362,2016,3
"100",15259305,5014925,17034672,12753868,26847155,76909925,5119235,14912527,13450124,12755434,4775449,51012769,112663389,127922694,2016,4
"101",17180000,7117376,18017691,8274768,25663138,76252973,17468654,14930795,5378711,7089050,18462884,63330094,122403067,139583067,2016,5
"102",25631100,1852741,21945916,5486900,21046268,75962925,3803031,20886504,10513747,4903067,6580038,46686387,97018212,122649312,2016,6
"103",12430538,13666191,8596564,7804564,32879606,75377463,11885987,16151461,11877574,12925603,16485260,69325885,132272810,144703348,2016,7
"104",20140353,2164522,23144751,4465009,25002276,74916911,10499728,23295184,11928466,3785524,9703965,59212867,113989425,134129778,2016,8
"105",21450000,10958863,8550593,8019942,25130242,74109640,9915073,5907171,18305233,5817094,3505394,43449965,96109605,117559605,2016,9
"106",19980000,5551333,14669690,11144550,20978970,72324543,11141107,17579573,6160859,7650838,13866511,56398888,108743431,128723431,2016,10
"107",14195413,7582248,17965568,4895878,26963355,71602462,15774614,15267615,15238247,10932963,20040214,77253653,134660702,148856115,2016,11
"108",8192029,9960806,20084145,4575686,28332177,71144843,18489165,14390783,15028993,5670300,21537490,75116731,138069545,146261574,2016,12
"109",20967647,5171763,19073522,5942819,19298535,70454286,23704115,12115452,6216592,11210539,16623998,69870696,119357335,140324982,2016,13
"110",19910320,4891731,20545094,3544204,20810535,69701884,14048475,32922762,1857299,10976780,16459880,76265196,126056760,145967080,2016,14
"111",4623009,2818849,19361975,5870639,36972041,69646513,10767380,19443717,7072959,12697085,20847900,70829041,135852545,140475554,2016,15
"112",23338824,3971695,17699492,6514242,17174595,68698848,8782820,8535944,13539421,11189104,8071148,50118437,95478461,118817285,2016,16
"113",25595300,9665597,15930551,3014714,13382316,67588478,9138463,24753166,12393270,3598913,21773449,71657261,113650439,139245739,2016,17
"114",10864196,5551588,14724668,11943324,23735090,66818866,33501913,7011441,11297021,7647569,16930497,76388441,132343111,143207307,2016,18
"115",24056900,2492212,13619295,8561035,18007403,66736845,7240013,17109523,4802149,18916487,13055152,61123324,103803269,127860169,2016,19
"116",10107898,5337110,20760335,2530923,27844419,66580685,21908891,2652225,10859069,7858962,24531901,67811048,124283835,134391733,2016,20
"117",9960643,10317028,4931355,6394996,33687976,65291998,9762192,19854836,12105117,11531668,7119979,60373792,115705147,125665790,2016,21
"118",20232200,8036819,16078663,4923789,14976072,64247543,17326136,21124929,7381104,15661151,5252667,66745987,110761330,130993530,2016,22
"119",7534058,7603960,14852328,10992080,21398613,62381039,15355883,17193846,8042363,10382798,13084964,64059854,118906835,126440893,2016,23
"120",14412646,7911734,6448981,2062362,31103538,61939261,22938450,14197538,14400101,5327548,19939515,76803152,124329767,138742413,2016,24
"121",13281182,1974686,6367688,11317299,28834646,61775501,17479805,24908290,8873417,11884805,12949485,76095802,124590121,137871303,2016,25
"122",23694507,3028926,11876072,5615042,16923639,61138186,9996826,13678890,16215848,10807904,9075198,59774666,97218345,120912852,2016,26
"123",10286322,10305929,12971463,7994746,19315114,60873574,22682421,11436205,4326517,14367753,15208647,68021543,118608795,128895117,2016,27
"124",9453311,6684248,16984504,7779092,18948473,59849628,12337912,22337341,9904864,6193434,14857989,65631540,116027857,125481168,2016,28
"125",18997000,2236171,13750952,12684653,6307577,53976353,5661793,17312549,15426110,17920176,20642727,76963355,111942708,130939708,2016,29
"126",18617300,4961190,5224319,5726719,19176356,53705884,5140464,9660901,9598215,16579686,4828050,45807316,80895900,99513200,2016,30
"127",2261161,7652724,24631438,4002548,14289846,52837717,14874328,22787306,6341732,11486444,22329018,77818828,128395384,130656545,2016,31
"128",11022385,2873269,8060225,3663632,20849784,46469295,11120534,1500998,6626100,2503713,23427666,45179011,80625921,91648306,2016,32
"129",21004781,13113454,17778997,3945253,39055012,94897497,15833947,8183830,6906583,12475138,11466541,54866039,128758755,149763536,2017,1
"130",17066663,3913937,21228435,8513978,43010782,93733795,4925768,16020328,3913692,11365174,22873492,59098454,135765586,152832249,2017,2
"131",27422800,5928217,28103286,4019531,25830636,91304470,11309437,18256298,8512929,6556132,15535401,60170197,124051867,151474667,2017,3
"132",27543600,4474359,10894949,11840649,34757110,89510667,12451986,17002208,8198492,6606862,24425407,68684955,130652022,158195622,2017,4
"133",29489118,3666976,20439056,6097469,28917997,88610616,11978095,14486303,6172044,15728455,21047533,69412430,128533928,158023046,2017,5
"134",21034437,2394382,31564129,3754657,28553585,87301190,14712089,26170012,2563395,11727962,9272758,64446216,130712969,151747406,2017,6
"135",7948686,7712155,20433394,10106000,34671590,80871825,14920141,21800072,14705805,14776850,4361412,70564280,143487419,151436105,2017,7
"136",21278625,2385295,14645439,10633090,31878770,80821219,14795376,16993112,11977212,7234912,17788027,68788639,128331233,149609858,2017,8
"137",22710632,11316345,7593965,15861068,22836833,80318843,19975799,14930437,27237850,7693071,6607630,76444787,134052998,156763630,2017,9
"138",20365000,6649958,7172234,13281931,32749192,80218315,7351727,15826140,11368168,9465615,5035764,49047414,108900729,129265729,2017,10
"139",14476471,11010522,18838336,12917262,22196744,79439335,10484357,5229052,13278110,23735041,16603309,69329869,134292733,148769204,2017,11
"140",33058282,3310080,9776316,9519411,22688764,78352853,21338272,20091185,11883805,11301524,5758889,70373675,115668246,148726528,2017,12
"141",26742000,5270289,16212624,5393387,23346656,76964956,8609329,11289373,5332555,12619611,15031988,52882856,103105812,129847812,2017,13
"142",1782314,7879602,26062634,16565097,23737956,76027603,4846639,17309055,13571954,3098994,10844663,49671305,123916594,125698908,2017,14
"143",16798413,7569296,24430688,9413806,17247941,75460144,12361126,14384255,17613896,10969118,22900422,78228817,136890548,153688961,2017,15
"144",19155000,5059879,20577484,8986982,21498674,75278019,17068671,23167189,5864393,6553828,9329846,61983927,118106946,137261946,2017,16
"145",10238211,11190118,6496909,11467859,35796366,75189463,10325927,13718331,7077973,7686153,5801497,44609881,109561133,119799344,2017,17
"146",22129791,6704574,15603598,10039875,20295961,74773799,14868181,21252770,3079205,7567614,4398800,51166570,103810578,125940369,2017,18
"147",17047200,5553764,18671297,5529031,22993789,69795081,15087353,14892449,12040537,11021745,17917711,70959795,123707676,140754876,2017,19
"148",21444105,6846041,14572454,4806305,21971246,69640151,13231093,26432590,11922152,3870386,27976841,83433062,131629108,153073213,2017,20
"149",10071983,13724506,13512773,7480525,23902263,68692050,36897369,8251178,13216415,15958866,13849553,88173381,146793448,156865431,2017,21
"150",3855907,9441681,22653336,10632622,20421501,67005047,17826431,14975844,9833223,10598898,21425963,74660359,137809499,141665406,2017,22
"151",22523284,6109029,10830686,7988864,19431712,66883575,13847877,15647606,10635653,11466277,21360634,72958047,117318338,139841622,2017,23
"152",11738985,8969129,18804531,3178912,23495847,66187404,30220786,9762983,8819460,8500031,17764740,75068000,129516419,141255404,2017,24
"153",21205288,4243728,5474701,7192941,25611612,63728270,16972578,35949428,6576004,14053421,6828257,80379688,122902670,144107958,2017,25
"154",3920973,6090264,25054318,4832368,23704519,63602442,18109284,23398406,9388589,8775903,24273641,83945823,143627292,147548265,2017,26
"155",7755133,6953354,25219237,3237501,20306285,63471510,19055848,15841769,17897035,5194177,22147687,80136516,135852893,143608026,2017,27
"156",15443870,5565665,8724467,12553573,21118436,63406011,9895825,19887433,18261753,20890487,23142234,92077732,140039873,155483743,2017,28
"157",10351646,8746428,19514493,7486458,17127063,63226088,20991161,23008834,9206570,13657831,15276846,82141242,135015684,145367330,2017,29
"158",8334184,10310192,8058956,2443262,29743163,58889757,30004586,5244382,5963101,6921694,16360022,64493785,115049358,123383542,2017,30
"159",2209957,4470494,5198547,3254760,41615803,56749561,5528898,9198852,21613135,3882857,7163759,47387501,101927105,104137062,2017,31
"160",1280189,2825514,13826473,3831656,25655347,47419179,8811687,17957489,8945957,9535769,6441770,51692672,97831662,99111851,2017,32
"161",38197259,8311842,18448916,3643398,33769652,102371067,10033146,16528345,8852841,6310620,18947503,60672455,124846263,163043522,2018,1
"162",25915200,7694424,18652510,11533431,36376204,100171769,11861506,2352299,10206380,11068824,11492532,46981541,121238110,147153310,2018,2
"163",22329200,7325063,24432270,2433131,40132972,96652636,6021602,11943939,8581239,9445802,26512595,62505177,136828613,159157813,2018,3
"164",22071928,1581868,26709607,10835666,32952576,94151645,19391088,23692894,4603006,2949361,10277116,60913465,132993182,155065110,2018,4
"165",22370588,6464791,11550945,16639653,35598047,92624024,11918322,17481245,6801489,5638443,21140054,62979553,133232989,155603577,2018,5
"166",24442360,5651728,19436865,7333699,34889282,91753934,2692766,13837156,21595019,5640141,18933305,62698387,130009961,154452321,2018,6
"167",26852600,7093841,12859196,7775068,35725330,90306035,7215630,20379299,14765854,7798629,8475586,58634998,122088433,148941033,2018,7
"168",23129200,4755413,25433190,7068484,27984393,88370680,14590006,22744570,6339835,10693090,17921985,72289486,137530966,160660166,2018,8
"169",25722676,2083712,20549797,13375573,25098865,86830623,5200125,18724742,3849218,6461829,5307934,39543848,100651795,126374471,2018,9
"170",26462000,8510220,15333845,9592122,26668316,86566503,18526098,18610741,18490720,15731056,22554099,93912714,154017217,180479217,2018,10
"171",12616903,3981361,34124743,10224401,25173502,86120910,30935514,21624467,14813639,6026118,15212917,88612655,162116662,174733565,2018,11
"172",21505365,5143228,16761079,7215415,35461396,86086483,19610353,20521371,7463300,16905015,5420767,69920806,134501924,156007289,2018,12
"173",23044200,7894058,15575488,16740476,20349864,83604086,8841997,12784037,12418619,22783881,15107401,71935935,132495821,155540021,2018,13
"174",22245471,6826065,12594544,9312292,32444025,83422397,25938492,15594755,18109544,8525314,10046763,78214868,139391794,161637265,2018,14
"175",10598281,2865819,26134139,16862132,25838059,82298430,16269909,26108093,12062109,4184476,18514959,77139546,148839695,159437976,2018,15
"176",17198153,6168245,22333466,9109741,26761854,81571459,17980043,21586114,18408108,6721891,22735864,87432020,151805326,169003479,2018,16
"177",24607847,1545560,13094252,5891394,35090781,80229834,18570996,7627086,15162163,7577505,18261233,67198983,122820970,147428817,2018,17
"178",15760757,8070717,13044099,3861826,36847212,77584611,16205890,5967157,11918348,10941303,27956260,72988958,134812812,150573569,2018,18
"179",27560000,7708425,10261176,4771517,26454707,76755825,6088251,19866349,13152062,13868343,12942767,65917772,115113597,142673597,2018,19
"180",24620964,4655724,20229810,3273982,22883379,75663859,5451644,5314490,26759580,26285750,7339007,71150471,122193366,146814330,2018,20
"181",10507195,4122610,25766603,4425226,30559407,75381041,5156706,38276611,14286351,13320269,3678898,74718835,139592681,150099876,2018,21
"182",10786333,12425774,17287457,4822038,28024882,73346484,49441021,1915141,11985485,11226426,27090280,101658353,164218504,175004837,2018,22
"183",1816903,7705768,17811897,2372304,43159686,72866558,5600665,30183328,18325353,4718347,5642991,64470684,135520339,137337242,2018,23
"184",6462373,3839568,13410657,12846159,35054355,71613112,13806414,30874001,6439413,20988021,5449388,77557237,142707976,149170349,2018,24
"185",23411925,11329128,12265128,7070209,16351639,70428029,6466608,23401317,7366336,5267371,13155011,55656643,102672747,126084672,2018,25
"186",27572118,3363334,12886087,4763673,21740115,70325327,10287179,11748483,10994045,16441962,26734432,76206101,118959310,146531428,2018,26
"187",9704446,6578378,8480482,11782366,33732729,70278401,26799400,19778901,12351575,11696707,20975177,91601760,152175715,161880161,2018,27
"188",15706000,1963621,14510892,2980830,27685340,62846683,19610747,22060696,13626497,8651558,23101585,87051083,134191766,149897766,2018,28
"189",8767592,9038320,14151679,2758153,27763882,62479626,39110096,5771005,10912796,13578223,20726753,90098873,143810907,152578499,2018,29
"190",4498746,8781571,22937792,3958681,21831728,62008518,19458959,20876470,10503200,11881679,32029767,94750075,152259847,156758593,2018,30
"191",5229993,6642019,21383544,8338914,16580007,58174477,6574896,22609536,12827408,8859951,16131635,67003426,119947910,125177903,2018,31
"192",4972932,12700103,3135006,10226000,13535618,44569659,13874163,18752548,8735891,12472941,7366816,61202359,100799086,105772018,2018,32
"193",30060000,2275911,16313123,16508239,45779795,110937068,8776062,18915217,4713346,8930462,13575522,54910609,135787677,165847677,2019,1
"194",23770750,5056256,21774081,11313773,42981228,104896088,21184145,18583642,17521770,5355326,6147003,68791886,149917224,173687974,2019,2
"195",27064655,6477550,23608026,7014216,37523591,101688038,6815527,32558522,11889408,7265608,12377117,70906182,145529565,172594220,2019,3
"196",29974202,8218621,9962196,17664279,32197919,98017217,11134561,18408787,3849469,7558867,22689383,63641067,131684082,161658284,2019,4
"197",17389080,7753530,28740271,10882654,32697458,97462993,18381875,13617308,4597140,7071863,23542739,67210925,147284838,164673918,2019,5
"198",25688481,8002165,14399349,5767514,40914105,94771614,5970975,10718493,8512658,19976408,9652415,54830949,123914082,149602563,2019,6
"199",11826075,3404034,35727967,6562380,36723539,94243995,11397361,24112662,14396593,15255977,21268697,86431290,168849210,180675285,2019,7
"200",21532358,14578972,15938972,4258221,37558398,93866921,7219127,39706057,15326818,10736568,14706919,87695489,160030052,181562410,2019,8
"201",26595000,3756693,13051443,6502176,42560951,92466263,10807620,14664025,20311789,4190537,16638197,66612168,132483431,159078431,2019,9
"202",2903516,7258235,23195205,6115957,52928659,92401572,16270733,23592008,14935984,5626954,11759970,72185649,161683705,164587221,2019,10
"203",23283000,7319205,16140089,8786988,34418326,89947608,25607015,8743596,10915774,8433793,30531666,84231844,150896452,174179452,2019,11
"204",11793235,2907359,31309352,14444000,29040221,89494167,2636098,35030070,4862403,9200559,21669013,73398143,151099075,162892310,2019,12
"205",28405163,8989981,16166352,8759798,26599108,88920402,7672043,11674925,14231925,8300429,5000958,46880280,107395519,135800682,2019,13
"206",29905000,4409766,22442158,6058384,24116130,86931438,15106796,23691333,12871959,15018703,27075664,93764455,150790893,180695893,2019,14
"207",11765577,12126193,26412655,4228642,31811467,86344534,30585660,17851822,6129397,9800904,11806937,76174720,150753677,162519254,2019,15
"208",31930059,2307429,17465459,6730065,27129944,85562956,15087044,9609031,15306901,5017157,23637112,68657245,122290142,154220201,2019,16
"209",9288808,6758058,25947032,12691900,30594087,85279885,7958341,13963072,11996608,14285030,9297683,57500734,133491811,142780619,2019,17
"210",18063000,9484109,15332230,5258881,36609416,84747636,17244922,10698868,21102931,10218404,17012133,76277258,142961894,161024894,2019,18
"211",26996766,5035413,12335319,6730075,33430896,84528469,5120514,21581217,27139216,10653670,4300635,68795252,126326955,153323721,2019,19
"212",14278779,5468274,19997045,7822805,36444965,84011868,17465235,11566811,7692784,20577441,9679240,66981511,136714600,150993379,2019,20
"213",22535204,12229419,20229111,2677268,23741152,81412154,6821358,10952860,17073342,27918225,18863654,81629439,140506389,163041593,2019,21
"214",9491711,11432801,19374147,3093662,35809241,79201562,19018512,5465480,25047180,11243424,22098745,82873341,152583192,162074903,2019,22
"215",27991392,1766913,4570576,8105668,36091768,78526317,31563825,14409336,13056501,5534972,18112322,82676956,133211881,161203273,2019,23
"216",7833793,12744125,27327533,3376502,26680848,77962801,25498793,17794602,9961506,10155128,20683883,84093912,154222920,162056713,2019,24
"217",14055437,1792775,28561458,12492121,19864821,76766612,18306693,19067986,16116704,5683006,30304445,89478834,152190009,166245446,2019,25
"218",8296599,12140266,16674681,3588603,34014338,74714487,10667138,21964198,7709824,4786932,17466133,62594225,129012113,137308712,2019,26
"219",13149963,9322496,13956013,5508925,32106212,74043609,27738114,7443609,12613248,6361198,24220950,78377119,139270765,152420728,2019,27
"220",24395545,6283177,9197102,9028498,22616326,71520648,30399334,18490862,22276998,8586514,7357669,87111377,134236480,158632025,2019,28
"221",6713826,4562191,18785529,10198933,31194376,71454855,21159179,26135699,11160531,12774835,7549959,78780203,143521232,150235058,2019,29
"222",4187820,4647747,12405040,6811187,24600941,52652735,21429512,5276260,5177136,23587904,39039526,94510338,142975253,147163073,2019,30
"223",6936162,4939853,4509420,7329076,26251247,49965758,19079701,32887968,7801084,11185503,19461415,90415671,133445267,140381429,2019,31
"224",7119898,1989719,21269506,2790180,10059484,43228787,7091738,4500733,5242573,30648047,17524815,65007906,101116795,108236693,2019,32
"225",47105566,5629641,19610611,10806164,50913166,134065148,29317501,19644725,7983967,7437136,13393415,77776744,164736326,211841892,2020,1
"226",31625000,8300028,18214691,15657398,53138925,126936042,13236548,18222524,16390125,20138076,8384032,76371305,171682347,203307347,2020,2
"227",21452022,3762174,29943350,15435113,39993612,110586271,26475772,13051595,5348034,9032645,8624266,62532312,151666561,173118583,2020,3
"228",27556500,6969905,14176858,19792747,40217623,108713633,20612811,29946760,19483225,4118737,6785738,80947271,162104404,189660904,2020,4
"229",23182000,8686298,21162541,6544772,47116265,106691876,14054420,15690717,7625164,13768642,21504501,72643444,156153320,179335320,2020,5
"230",24645540,7058628,20521932,5301804,47239400,104767304,15375862,35768583,8225930,14695548,9592282,83658205,163779969,188425509,2020,6
"231",11937673,6893053,33178607,8176049,40583203,100768585,17914080,26132262,6861412,8729755,19017592,78655101,167486013,179423686,2020,7
"232",35728728,12355915,18148958,6554264,27902811,100690676,13809747,13774001,18954155,5243874,9660756,61442533,126404481,162133209,2020,8
"233",7250503,5099201,36777928,12578400,36669047,98375079,18388976,27380548,21534268,23192615,7893856,98390263,189514839,196765342,2020,9
"234",14334715,16353897,23107507,6027564,37592815,97416498,23808729,15729420,17873795,6583032,16539902,80534878,163616661,177951376,2020,10
"235",8756449,5465493,34088188,10368680,38644130,97322940,21223086,31426602,16719363,16659474,20736847,106765372,195331863,204088312,2020,11
"236",32063900,9951728,16222301,12094038,26646044,96978011,11979291,11274881,33886063,12326346,9927702,79394283,144308394,176372294,2020,12
"237",21507782,9372815,26854214,3078558,35991007,96804376,17819198,14691090,13006119,17770690,7025458,70312555,145609149,167116931,2020,13
"238",28656986,12651495,11274168,8237185,34553407,95373241,6427647,33179317,4658200,12992886,23135002,80393052,147109307,175766293,2020,14
"239",29615000,10071475,15878580,12711179,26828544,95104778,15509386,14776363,14017409,6835585,15982911,67121654,132611432,162226432,2020,15
"240",7882344,10305900,37184947,9965411,27247745,92586347,29271973,4182486,5961669,13144334,27676010,80236472,164940475,172822819,2020,16
"241",8405304,13923430,23880958,7419447,35630875,89260014,24137314,7323895,16794724,14908372,13037624,76201929,157056639,165461943,2020,17
"242",13077156,7122592,19513770,16077000,32040903,87831421,8722061,37402743,15450481,8080983,22250416,91906684,166660949,179738105,2020,18
"243",29742082,4617451,16494036,12714317,22942443,86510329,33835477,12064881,3154812,6219689,12460591,67735450,124503697,154245779,2020,19
"244",16294775,5188323,25075558,10102779,29765996,86427431,23369611,34953918,11570430,7673452,22163187,99730598,169863254,186158029,2020,20
"245",15601427,12031841,16714487,2979798,35976093,83303646,26270183,11266370,13111927,8963659,4327671,63939810,131642029,147243456,2020,21
"246",23776471,4561066,17671718,10449973,22917842,79377070,8469068,26497026,16088641,8317073,27875270,87247078,142847677,166624148,2020,22
"247",25787420,3152932,5904043,8917978,34322786,78085159,31946840,20928988,14097958,7531643,22491577,96997006,149294745,175082165,2020,23
"248",9578101,10593827,23209798,5105235,29353069,77840030,12796580,32876967,18224888,6926444,25002424,95827303,164089232,173667333,2020,24
"249",22173100,7162164,17888635,11517438,17340511,76081848,8975453,11670056,24254783,23730611,7944494,76575397,130484145,152657245,2020,25
"250",21143235,4636838,5094070,5735630,37529075,74138848,14842436,23435574,10601855,17618175,12168640,78666680,131662293,152805528,2020,26
"251",3605328,11650746,18485266,2423440,37449919,73614699,13774273,10921606,2456912,13468641,40532199,81153631,151163002,154768330,2020,27
"252",10741087,2359512,20094445,6041573,30068651,69305268,19884603,5678171,16895382,8641644,9088228,60188028,118752209,129493296,2020,28
"253",13738107,6048483,12934747,5150508,25769545,63641390,8882281,30859088,9004600,15602600,34531218,98879787,148783070,162521177,2020,29
"254",2218968,4284150,13008642,7035664,34261623,60809047,9629144,10129711,25064762,6022218,15313716,66159551,124749630,126968598,2020,30
"255",5966788,8155745,12794229,8389562,21439554,56745878,30689647,25887415,6799282,6137220,36177351,105690915,156470005,162436793,2020,31
"256",3938956,9025620,9316695,7139192,24536776,53957239,23618489,36419854,3752646,27037756,20138402,110967147,160985430,164924386,2020,32
"257",18682463,11476969,38683182,17525258,52524578,138892450,20751036,19258579,6699177,10849707,16619496,74177995,194387982,213070445,2021,1
"258",24843787,15500915,33253422,8614464,36280127,118492715,11807153,30206942,16523084,7963027,16058861,82559067,176207995,201051782,2021,2
"259",10545588,8418567,39036499,16433000,36742114,111175768,21307605,18843760,13306056,5976082,8255097,67688600,168318780,178864368,2021,3
"260",22023066,9363800,20126345,12103265,45254723,108871199,32839199,6336630,9764424,6839520,19092649,74872422,161720555,183743621,2021,4
"261",40016425,7838364,25812138,9563040,25075978,108305945,18547728,29922350,4312430,12546837,12361050,77690395,145979915,185996340,2021,5
"262",31200000,15456770,8859055,7386250,42977640,105879715,6643187,16966682,8734161,18663642,10882756,61890428,136570143,167770143,2021,6
"263",30323355,10699500,22409509,6662498,32013469,102108331,10011994,11315490,16085421,14335685,9065669,60814259,132599235,162922590,2021,7
"264",1808816,4756336,40364244,9129579,43917565,99976540,20434900,17296923,16476063,17051353,6544693,77803932,175971656,177780472,2021,8
"265",22113529,13464705,25764320,6380548,29952603,97675705,16183711,14269075,20417499,12608208,28320275,91798768,167360944,189474473,2021,9
"266",12540781,5858841,40450650,10183185,27353158,96386615,15809246,9937991,16434300,18216048,38207773,98605358,182451192,194991973,2021,10
"267",33440000,8764806,13773094,6690177,33061622,95729699,6591765,14258658,21937580,19618404,8448979,70855386,133145085,166585085,2021,11
"268",26912500,3957891,31882131,5294914,25964921,94012357,28673915,13754166,13198531,3216728,10044755,68888095,135987952,162900452,2021,12
"269",28950000,7218334,13603642,8713493,35030910,93516379,10162953,37853938,6931976,19815358,12964206,87728431,152294810,181244810,2021,13
"270",10062788,15079102,21362790,15975500,30721326,93201506,23484598,8654146,12628988,17639771,26585296,88992799,172131517,182194305,2021,14
"271",26650000,11507897,15278836,8989598,29636965,92063296,13153750,29008516,21065500,9995144,9588609,82811519,148224815,174874815,2021,15
"272",11115796,6076587,32235447,3607183,37712992,90748005,21128461,21560367,25060037,16012335,13400522,97161722,176793931,187909727,2021,16
"273",13761250,7215387,14811031,7520000,47353545,90661213,24698612,13274677,9810452,21499756,25174667,94458164,171358127,185119377,2021,17
"274",7810281,8305086,36191284,7640000,29343665,89290316,17266115,28866966,7020163,6059484,22265000,81477728,162957763,170768044,2021,18
"275",22974000,11822500,16533923,3832591,33873579,89036593,11305001,15683673,10962604,17162000,17736492,72849770,138912363,161886363,2021,19
"276",12191221,5028768,24069815,4866250,42457389,88613443,21765415,35198035,17171728,13930772,7481454,95547404,171969626,184160847,2021,20
"277",11666666,7116577,26038589,13232224,27738942,85792998,26431889,32707418,14661242,8892500,8248610,90941659,165067991,176734657,2021,21
"278",3601958,5344481,16774560,16211044,43732121,85664164,37887939,20548398,7779614,7706028,13789478,87711457,169773663,173375621,2021,22
"279",7212557,8103544,19939341,16732377,31334593,83322412,14429708,18813626,17664421,28713711,33918268,113539734,189649589,196862146,2021,23
"280",3848343,7023435,12854981,5352387,52782425,81861571,16794514,14407903,31044021,13540531,20033308,95820277,173833505,177681848,2021,24
"281",32320000,7044317,12370126,13399152,15713560,80847155,14797871,22182614,23655231,14089375,18179418,92904509,141431664,173751664,2021,25
"282",6012042,14208005,16728541,5062263,36883773,78894624,13448212,32607213,8164940,13110000,26432994,93763359,166645941,172657983,2021,26
"283",28007867,2906125,10143563,9586631,28230794,78874980,29377534,15419091,10156306,7566720,20648545,83168196,134035309,162043176,2021,27
"284",22295000,4117460,18041467,10118283,22968906,77541116,25630462,9191295,6061495,6989244,16479265,64351761,119597877,141892877,2021,28
"285",10378381,6461409,26703287,11187500,22806089,77536666,19009977,29993415,16661344,23952601,7651490,97268827,164427112,174805493,2021,29
"286",10385033,11131967,15773645,9900051,29108626,76299322,23230605,17320390,5690520,12213926,32337330,90792771,156707060,167092093,2021,30
"287",4683880,6381559,13240944,12507939,32166756,68981078,37067271,6383327,7310441,9287450,32862311,92910800,157207998,161891878,2021,31
"288",13900000,5635022,10698573,8674955,25908734,64817284,10002677,30143408,14591006,7581392,11658453,73976936,124894220,138794220,2021,32
